111111111111111
1C0000011111111
100110011111111
1P0000111111111
111111111111111
